###################################################################################################################################################################################
#                                                                                                                                                                                 #
#                                                O                                                                                                                                 #
#     	      	      	      	      	      	      	      	      	      	      	      	      	      	      	       	      	      	      	      	      	      	  #
#     	      	      	      	      	      	      	      	  P    	      	      	      	      	      	      	       	      	      	      	      	      	      	  #
#     	      	      	      	X      	      	      	      	      	      	      	      	      	      	      	       	      	      	      	      	      	      	  #
#     	      	      	      	      	      	      	      	      	      	      	      	      	      	      	       	      	      	      	      	      	      	  #
#     	      	      	      	      	      	      	      	      	      	      	      	      	      	      	       	      	      	      	      	      	      	  #
#     	      	      	      	      	      	      	      	      	      	      	      	      	      	      	       	      	      	      	      	      	      	  #
#     	      	      	      	      	      	      	      	      	      	      	      	      	      	      	       	      	      	      	      	      	      	  #
#     	      	      	      	      	      	      	      	      	      	      	      	      	      	      	       	      	      	      	      	      	      	  #
#     	      	      	      	      	      	      	      	      	      	      	      	      	      	      	       	      	      	      	      	      	      	  #
#     	      	      	      	      	      	      	      	      	      	      	      	      	      	      	       	      	      	      	      	      	      	  #
#     	      	      	      	      	      	      	      	      	      	      	      	      	      	      	       	      	      	      	      	      	      	  #
#     	      	      	      	      	      	      	      	      	      	      	      	      	      	      	       	      	      	      	      	      	      	  #
#     	      	      	      	      	      	      	      	      	      	      	      	      	      	      	       	      	      	      	      	      	      	  #
#     	      	      	      	      	      	      	      	      	      	      	      	      	      	      	       	      	      	      	      	      	      	  #
#     	      	      	      	      	      	      	      	      	      	      	      	      	      	      	       	      	      	      	      	      	      	  #
#     	      	      	      	      	      	      	      	      	      	      	      	      	      	      	       	      	      	      	      	      	      	  #
#     	      	      	      	      	      	      	      	      	      	      	      	      	      	      	       	      	      	      	      	      	      	  #
#     	      	      	      	      	      	      	      	      	      	      	      	      	      	      	       	      	      	      	      	      	      	  #
#     	      	      	      	      	      	      	      	      	      	      	      	      	      	      	       	      	      	      	      	      	      	  #
#     	      	      	      	      	      	      	      	      	      	      	      	      	      	      	       	      	      	      	      	      	      	  #
#     	      	      	      	      	      	      	      	      	      	      	      	      	      	      	       	      	      	      	      	      	      	  #
#     	      	      	      	      	      	      	      	      	      	      	      	      	      	      	       	      	      	      	      	      	      	  #
#     	      	      	      	      	      	      	      	      	      	      	      	      	      	      	       	      	      	      	      	      	      	  #
#     	      	      	      	      	      	      	      	      	      	      	      	      	      	      	       	      	      	      	      	      	      	  #
#     	      	      	      	      	      	      	      	      	      	      	      	      	      	      	       	      	      	      	      	      	      	  #
#     	      	      	      	      	      	      	      	      	      	      	      	      	      	      	       	      	      	      	      	      	      	  #
#     	      	      	      	      	      	      	      	      	      	      	      	      	      	      	       	      	      	      	      	      	      	  #
#     	      	      	      	      	      	      	      	      	      	      	      	      	      	      	       	      	      	      	      	      	      	  #
#     	      	      	      	      	      	      	      	      	      	      	      	      	      	      	       	      	      	      	      	      	      	  #
#     	      	      	      	      	      	      	      	      	      	      	      	      	      	      	       	      	      	      	      	      	      	  #
#     	      	      	      	      	      	      	      	      	      	      	      	      	      	      	       	      	      	      	      	      	      	  #
#     	      	      	      	      	      	      	      	      	      	      	      	      	      	      	       	      	      	      	      	      	      	  #
#     	      	      	      	      	      	      	      	      	      	      	      	      	      	      	       	      	      	      	      	      	      	  #
#     	      	      	      	      	      	      	      	      	      	      	      	      	      	      	       	      	      	      	      	      	      	  #
#     	      	      	      	      	      	      	      	      	      	      	      	      	      	      	       	      	      	      	      	      	      	  #
#     	      	      	      	      	      	      	      	      	      	      	      	      	      	      	       	      	      	      	      	      	      	  #
#                                                                                                                                                                                 #
#                                                                                                                                                                                 #
#                                                                                                                                                                                 #
#                                                                                                                                                                                 #
#                                                                                                                                                                                 #
#                                                                                                                                                                                 #
#                                                                                                                                                                                 #
#                                                                                                                                                                                 #
#                                                                                                                                                                                 #
#                                                                                                                                                                                 #
###################################################################################################################################################################################