##################
#                #
#       X O  P   #
#                #
#                #
#                #
######## #########
#                #
#                #
#      X         #
#       X        #
#                #
##################